11111111111111111111
100000C00000C0000001
100000P0000000000001
1C000000110001111111
10000E00000C00000C01
11111111111111111111
