1111111111111111111
1C1C1C1C1C1C1111111
10101010101010000E1
1010101010101000001
1010101010101000001
1010101010101000001
10000000000000000P1
