111111111111
1C0000E00001
1P000C000001
111111111111