1111111111111111111111111111111111
1E0000000000000C000000000000000001
1010010100100000101000000000010101
1010010010101000001001000000010101
1000000000000000000000P00000000001
1111111111111111111111111111111111