111111111111111
1C00000000000P1
101111111111111
1C0000000000001
111111111111101
1000000000000C1
101111111111111
1C0000000000001
111111111111101
1E00000000000C1
111111111111111