111111111111111111111111111111111
100000001100111010010100101111011
1P001100000011100000C000000111111
100000000000000000000000000000001
1E0000000000000000C00000000000001
111111111111111111111111111111111